111111111111111111111111111111111111111111111111111400000111111101120111111101100111111100000111111101101111111101101111111100000031111111111111
111111111111110000011111110111000111100131110111101121310011101324211011101112231011100013111011111011100011111000001111111111111111111111111111
111111111111100000001111101111101111101400100011101012111011101020331011101111111011100000000011111111111111111111111111111111111111111111111111
111111111111100000011111101111000111101001110111101002410111101053010111101100010111100111110111110000000111111111111111111111111111111111111111
100000011111101111011111101001000111101001110111101002010111101151310111101004010111101000010111101001110111101111000111100000011111111111111111
111111111111111111111111110000000001110111111101110130203101110102420101110130203101110111111101110000000001111111111111111111111111111111111111
111111111111111111111111100000000001101111111101101003320101101024020101101023300101101111111101100000000001111111111111111111111111111111111111
111111111111111111111111110000000001110111111101100100000101101103230101101402020101101003230101101100000101100111111101110000000001111111111111
111111111111111111111111100000000001101111111101101023023101101432023101101023023101101032023101101111111101100000000001111111111111111111111111
111111111111110000000011100111111001101100011101101001000101101010010101101020210101101310000101101304111101101111100001100000001111111111111111
111111111111111000000000110011111110110110010410110100010010110120202010000102110010011102010110013333300100011111111101000000000001111111111111
111111111111000000000001011111111101010005000101010231320101010023200101011132311101000114110001110011100111111000001111111111111111111111111111
111111111111111000000011100011111011101110001011101403231011101002021011101113231011100010001011111011111011111000000011111111111111111111111111
111111111111110000001111110111101111000100100000011100111110010033200010014233020010011102111110000100100000110111101111110000001111111111111111
111111111111111111111111100000000000001111111110011000000010010001212010010220032310010411133310011110111110000000000000111111111111111111111111
111111111111111111111111000000000000011111111110110001400011102033332001100211110201100010010011111110011110000000000000111111111111111111111111
111111111111111111111111000000000011011111111011010000401001010233001101011133100101000112220101110010000101111011111101111000000001111111111111
111111111111100000000001101111111101101000400101101022100101101100201101100132001001110113011011110013310011111011110111111000000111111111111111
111111111111110000000011110111111011110130331011100130231001101110021101101020020101101012110101101000400101101111111101100000000001111111111111
111111111111111000000001111011111101100010000101101112220101101402330101101023331101101111001001100001111011111100000011111111111111111111111111